_date_,apt_start,semi_start,row_start,sfd_start,total_start,multi_start,,,,
3/31/1980,429,320,286,976,2011,1035,,,,
6/30/1980,653,368,445,1288,2754,1466,,,,
9/30/1980,396,414,469,1521,2800,1279,,,,
12/31/1980,1025,278,409,1827,3539,1712,,,,
3/31/1981,451,340,217,1756,2764,1008,,,,
6/30/1981,1488,312,458,2555,4813,2258,,,,
9/30/1981,1585,124,676,1850,4235,2385,,,,
12/31/1981,1909,106,558,787,3360,2573,,,,
3/31/1982,802,246,85,657,1790,1133,,,,
6/30/1982,1753,158,1139,1205,4255,3050,,,,
9/30/1982,735,38,451,483,1707,1224,,,,
12/31/1982,744,28,280,795,1847,1052,,,,
3/31/1983,658,52,147,681,1538,857,,,,
6/30/1983,690,18,131,1436,2275,839,,,,
9/30/1983,38,20,41,446,545,99,,,,
12/31/1983,26,0,18,480,524,44,,,,
3/31/1984,0,2,35,289,326,37,,,,
6/30/1984,0,0,5,608,613,5,,,,
9/30/1984,0,2,4,567,573,6,,,,
12/31/1984,0,4,0,287,291,4,,,,
3/31/1985,0,0,5,252,257,5,,,,
6/30/1985,0,0,0,430,430,0,,,,
9/30/1985,0,2,0,758,760,2,,,,
12/31/1985,7,10,0,854,871,17,,,,
3/31/1986,0,2,0,651,653,2,,,,
6/30/1986,15,20,11,587,633,46,,,,
9/30/1986,46,24,0,421,491,70,,,,
12/31/1986,264,22,163,453,902,449,,,,
3/31/1987,0,12,0,412,424,12,,,,
6/30/1987,20,8,19,932,979,47,,,,
9/30/1987,68,14,0,1015,1097,82,,,,
12/31/1987,0,34,129,803,966,163,,,,
3/31/1988,0,8,22,657,687,30,,,,
6/30/1988,11,14,3,866,894,28,,,,
9/30/1988,0,156,0,920,1076,156,,,,
12/31/1988,4,158,97,884,1143,259,,,,
3/31/1989,0,72,148,785,1005,220,,,,
6/30/1989,0,48,0,1515,1563,48,,,,
9/30/1989,45,24,263,1421,1753,332,,,,
12/31/1989,264,62,24,1557,1907,350,,,,
3/31/1990,3,126,69,1964,2162,198,,,,
6/30/1990,180,52,280,1791,2303,512,,,,
9/30/1990,254,66,115,951,1386,435,,,,
12/31/1990,34,32,229,858,1153,295,,,,
3/31/1991,34,26,12,652,724,72,,,,
6/30/1991,78,46,45,1263,1432,169,,,,
9/30/1991,36,34,73,1164,1307,143,,,,
12/31/1991,24,152,40,1071,1287,216,,,,
3/31/1992,27,64,66,1140,1297,157,,,,
6/30/1992,93,92,154,1951,2290,339,,,,
9/30/1992,37,90,163,1407,1697,290,,,,
12/31/1992,17,116,133,1484,1750,266,,,,
3/31/1993,18,68,203,965,1254,289,,,,
6/30/1993,86,102,174,1468,1830,362,,,,
9/30/1993,113,52,223,1295,1683,388,,,,
12/31/1993,23,106,241,1492,1862,370,,,,
3/31/1994,4,50,57,1120,1231,111,,,,
6/30/1994,23,72,158,1780,2033,253,,,,
9/30/1994,302,124,295,1239,1960,721,,,,
12/31/1994,345,92,176,1040,1653,613,,,,
3/31/1995,14,36,91,812,953,141,,,,
6/30/1995,48,66,138,1182,1434,252,,,,
9/30/1995,280,70,171,1235,1756,521,,,,
12/31/1995,189,54,141,1158,1542,384,,,,
3/31/1996,191,18,39,869,1117,248,,,,
6/30/1996,32,82,126,1763,2003,240,,,,
9/30/1996,182,72,86,1764,2104,340,,,,
12/31/1996,110,120,191,1466,1887,421,,,,
3/31/1997,340,82,153,1884,2459,575,,,,
6/30/1997,275,130,160,2317,2882,565,,,,
9/30/1997,213,124,251,2174,2762,588,,,,
12/31/1997,289,152,390,2281,3112,831,,,,
3/31/1998,489,124,169,2089,2871,782,,,,
6/30/1998,363,114,228,2817,3522,705,,,,
9/30/1998,375,128,187,2437,3127,690,,,,
12/31/1998,731,160,208,1876,2975,1099,,,,
3/31/1999,817,122,191,1211,2341,1130,,,,
6/30/1999,527,172,141,1876,2716,840,,,,
9/30/1999,634,168,168,1853,2823,970,,,,
12/31/1999,813,114,120,1673,2720,1047,,,,
3/31/2000,664,94,52,1455,2265,810,,,,
6/30/2000,842,124,99,1967,3032,1065,,,,
9/30/2000,537,220,303,1761,2821,1060,,,,
12/31/2000,937,196,276,1566,2975,1409,,,,
3/31/2001,403,96,156,1395,2050,655,,,,
6/30/2001,555,194,308,2092,3149,1057,,,,
9/30/2001,304,234,267,2219,3024,805,,,,
12/31/2001,913,132,228,1853,3126,1273,,,,
3/31/2002,669,110,223,1810,2812,1002,,,,
6/30/2002,877,150,197,2838,4062,1224,,,,
9/30/2002,667,240,449,2552,3908,1356,,,,
12/31/2002,818,226,300,2213,3557,1344,,,,
3/31/2003,1338,174,322,1961,3795,1834,,,,
6/30/2003,653,224,389,2405,3671,1266,,,,
9/30/2003,546,176,276,2188,3186,998,,,,
12/31/2003,488,224,306,1972,2990,1018,,,,
3/31/2004,1050,192,207,1804,3253,1449,,,,
6/30/2004,1066,232,232,2224,3754,1530,,,,
9/30/2004,639,282,275,2188,3384,1196,,,,
12/31/2004,1160,212,228,2017,3617,1600,,,,
3/31/2005,691,160,281,1779,2911,1132,,,,
6/30/2005,508,268,331,2372,3479,1107,,,,
9/30/2005,1073,286,281,2342,3982,1640,,,,
12/31/2005,533,274,262,2226,3295,1069,,,,
3/31/2006,946,258,153,2487,3844,1357,,,,
6/30/2006,1524,282,297,3082,5185,2103,,,,
9/30/2006,647,298,330,2735,4010,1275,,,,
12/31/2006,1294,294,241,2178,4007,1829,,,,
3/31/2007,506,258,293,1717,2774,1057,,,,
6/30/2007,1130,274,477,2182,4063,1881,,,,
9/30/2007,1078,260,414,2215,3967,1752,,,,
12/31/2007,652,212,174,1663,2701,1038,,,,
3/31/2008,3130,214,245,1067,4656,3589,,,,
6/30/2008,1491,204,205,1261,3161,1900,,,,
9/30/2008,678,162,131,1073,2044,971,,,,
12/31/2008,404,94,93,986,1577,591,,,,
3/31/2009,84,88,15,559,746,187,,,,
6/30/2009,4,184,57,990,1235,245,,,,
9/30/2009,101,298,156,1561,2116,555,,,,
12/31/2009,199,178,179,1665,2221,556,,,,
3/31/2010,205,204,224,1528,2161,633,,,,
6/30/2010,95,266,288,1807,2456,649,,,,
9/30/2010,920,198,300,1402,2820,1418,,,,
12/31/2010,129,258,393,1045,1825,780,,,,
3/31/2011,196,158,213,981,1548,567,,,,
6/30/2011,82,236,295,1369,1982,613,,,,
9/30/2011,676,270,342,1417,2705,1288,,,,
12/31/2011,1152,254,334,1317,3057,1740,,,,
3/31/2012,1382,196,366,1256,3200,1944,,,,
6/30/2012,1478,276,516,1574,3844,2270,,,,
9/30/2012,445,348,516,1652,2961,1309,,,,
12/31/2012,689,308,360,1479,2836,1357,,,,
3/31/2013,379,340,359,1427,2505,1078,,,,
6/30/2013,625,384,390,1658,3057,1399,,,,
9/30/2013,708,304,521,1738,3271,1533,,,,
12/31/2013,1263,308,601,1579,3751,2172,,,,
3/31/2014,1939,362,504,1460,4265,2805,,,,
6/30/2014,2071,374,721,1863,5029,3166,,,,
9/30/2014,1733,348,679,1749,4509,2760,,,,
12/31/2014,991,422,493,1422,3328,1906,,,,
3/31/2015,1280,246,462,1189,3177,1988,,,,
6/30/2015,1599,318,562,972,3451,2479,,,,
9/30/2015,1454,254,546,949,3203,2254,,,,
12/31/2015,1412,260,502,1028,3202,2174,,,,
3/31/2016,554,140,213,660,1567,907,,,,
6/30/2016,896,254,337,806,2293,1487,,,,
9/30/2016,1432,250,307,1049,3038,1989,,,,
12/31/2016,819,308,246,974,2347,1373,,,,3489
3/31/2017,780,224,275,800,2079,1279,,,,
6/30/2017,1356,344,530,1216,3446,2230,,,,
9/30/2017,713,448,425,1283,2869,1586,,,,
12/31/2017,1377,302,337,1124,3140,2016,,7111,4226,4423
3/31/2018,570,244,319,927,2060,1133,,,,
6/30/2018,2129,358,347,1085,3919,2834,,,,
9/30/2018,1187,360,409,984,2940,1956,,,,
12/31/2018,517,254,486,795,2052,1257,,7180,4403,3791
3/31/2019,501,186,473,662,1822,1160,,,,
6/30/2019,1225,298,497,858,2878,2020,,,,
9/30/2019,1615,346,343,1003,3307,2304,,,,
12/31/2019,2042,308,540,1012,3902,2890,20283,8374,5383,3535
3/31/2020,667,270,362,933,2232,1299,,,,
6/30/2020,602,214,184,721,1721,1000,,,,
9/30/2020,1040,220,486,762,2508,1746,,,,
12/31/2020,990,316,397,1071,2774,1703,14983,5748,3299,3487
